111111111111111
100000000000001
10000000000P001
100001111110001
100000000000001
100000000000001
100000000000001
111111111111111