NO north
SO south
WE west
EA east
         111111111111111
100000000000001
10000000000S001
100001111110001
100000000000001
100000000000001
100000000000001
100000000000001
100000000000001
100000000000001
100000000000001
100001101110001
100000000000001
100000000000001
111011101101111
111111101111111
111111101111111
100000000000001
100000000000001
100001101110001
100000000000001
100000000000001
111011111101111
111111111111111