NO north
SO south




WE west
EA east

F 220,100,0
C 225,30,0
111111111111111
100000000000001
10000000000S001
100001111110001
100000000000001
100000000000001
110110111111011
100001111110001
100000000000001
100000000000001
110110111111011
100001111110001
100000000000001
100000000000001
110110111111011
100001111110001
100000000000001
100000000000001
110110111111011
111111111111111