NO north
SO south
WE west
EA east
111111111111111
100000000000001
10000000000S001
100001111110001
100000000000001
100000000000001
100000000000001
111111111111111