NO tex/eagle.xp
SO tex/wood.xpm
WE tex/redbrick.xpm
EA tex/mossy.xpm
D sprites/door.xpm

F 255,0,6
C 0,0,255

         11111111111111111111111111111
         10000000001100000000000000001
         10110000011100000001111111111
11111111110000000000000000011111
        101100000111000000000111111
111111111001100000111011110011
1111011111111101110000001000111111111111111111111111111111
         100000000011000E0000000000001
         10110000011100000001111111111
11111111110000000000000000011111
        101100000000000000111111
11111111000000000000000001
10000000111100001111100001
10110001101100011111110001
10000011001100000001100001
10000111111100000011000001
10110000001100000110000001
10110000001100001111111001
11111111111111111111111111
