NO tex/eagle.xpm
SO tex/wood.xpm
WE tex/redbrick.xpm
EA tex/mossy.xpm

F 20,20,20
C 200,200,200

11111
10W01
11111