NO tex/eagle.xpm
SO tex/wood.xpm
WE tex/redbrick.xpm
EA tex/mossy.xpm

F 255,0,6
C 0,0,255


     11111  
    100S001
     10001
      101
       1
