F 139,99,58
C 171,154,137

NO tex/eagle.xpm
SO tex/wood.xpm
WE tex/redbrick.xpm
EA tex/mossy.xpm
DO sprites/door.xpm

1111111111111111111
1001001001001001001
1001001001001001001
1001000001000001001
1001000000000001001
100000000S000000001
1000000000000000001
1111000000000001111
1000000101010000001
1111111111111111111
