NO tex/eagle.xpm
SO tex/wood.xpm
WE tex/redbrick.xpm
EA tex/mossy.xpm

F 164,169,20
C 153,204,255

111111111111111111111
1010000010000P0000001
101010101011111110001
100010100010000010001
111110101111101011101
100000101000101000001
101111101011101111111
10100P001010100000101
101011111010111110101
10101000101P100010101
101110101010101010101
100000101010001010001
1111111010111110111P1
100000101000100010001
101110101110101110111
101000100000100010101
1P1011111111111010101
10P010000000000010001
101010111011111111101
1N100P00100000P000001
111111111111111111111


