NO tex/eagle.xpm
SO tex/wood.xpm
WE tex/redbrick.xpm
EA tex/mossy.xpm

F 48,48,48
C 206,206,206

  1111      11111111111
 100001 1  100000000P01
10000011011100000000101
 1010010000P00111100101
100000P0000101   10010111111
 10000111P111    10010100001
10000011100001  110110P000W1
 11P1111000001 101P110100001
 100011101P111 1000110111111
 10001  110011111111101
 1111111110000000000001
 10000000110111111P11111
100000000P001  1000000001
 100000001111 1000000001
1000000001     1000000001
 100000001      11100111
  1110111         1111
     1
