NO tex/eagle.xpm
SO tex/wood.xpm
WE tex/redbrick.xpm
EA tex/mossy.xpm
DO sprites/door.xpm

F 48,48,48
C 206,206,206

  1111      11111111111
 100001 1  100000000001
10000011011100000000101
 1010010000000111100101
10000000000101   10010111111
 100001110111    10010100001
10000011100001  1101100000W1
 1101111000001 1010110100001
 1000111010111 1000110111111
 10001  110011111111101
 1111111110000000000001
 10000000110111111011111
1000000000001  1000000001
 100000001111 1000000001
1000000001     1000000001
 100000001      11100111
  1110111         1111
     1
