NO tex/eagle.xpm
SO tex/wood.xpm
WE tex/redbrick.xpm
EA tex/mossy.xpm

F 48,48,48
C 206,206,206

     11111111       111        1111111 111111111
    1000000001      101       100000P0100000000011
   100111111001     101       1011111000011111100P11
  10011     111     101       11     10001     110001
 1001         1     1P1  1111         1001       10001
1001       111      1001100001        1P11        10001
1001       101      10010P11001       1001         1001
1001       101      100001  1001    110001         1001
1P1        101      10001    1001111000111         1001
101        101      1001      1N0P00000111         1001
101        101      1001      101111110001         1001
101        101      1001      1001    1001         1001
1001       101      1001      1001    1001         1001
1001       1P1      1001      101      1P1        10001
 1001      1001     1P11      1P1     1001        1001
 10001     1001    100001    1001    10001      110001
  10001111100011111000000111100011111000011111110P011
   1100000000000P00010010P00001000P0001000P000000111
     111111111111111 11 1111111111111111111111111
